Anno;Giovani_(0-14_anni);Adulti_(15-64_anni);Anziani_(65+_anni);Numero_Abitanti;Eta_Media
2012;2236;10579;3119;15934;44,0
2013;2293;10628;3310;16231;44,2
2014;2307;10577;3453;16337;44,5
2015;2270;10566;3533;16369;44,8
2016;2283;10533;3606;16422;45,0
2017;2267;10536;3684;16487;45,2
2018;2230;10466;3783;16479;45,6
2019;2219;10398;3828;16445;45,7
2020;2197;10346;3894;16437;46,0
2021;2197;10346;3894;16437;46,3
